Transform Color	Code
White	whit
Light Grey	lgry
Dark Grey	dgry
Black	blac
Light Blue	lblu
Dark Blue	dblu
Crystal Blue	cblu
Light Red	lred
Dark Red	dred
Crystal Red	cred
Light Green	lgrn
Dark Green	dgrn
Crystal Green	cgrn
Light Yellow	lyel
Dark Yellow	dyel
Light Gold	lgld
Dark Gold	dgld
Light Purple	lpur
Dark Purple	dpur
Orange	oran
Bright White	bwht
